XXXXXXXXXXXXXXXXXXXXXXXXXXXXXXXXXXXXXXXXXXXXXX
XXXXXXXXXXXXXXXXXXXXXXXXXXXXXXXXXXXXXXXXXXXXXX
XXXXXXXXXXXXXXXXXXXXXXXXXXXXXXXXXXXXXXXXXXXXXX
XXX0444444444444444444444444444444444444444XXX
XXX4444444444444444444444444444444444444444XXX
XXX4444444444444444444444444444444444444444XXX
XXX4444444444444444444444444444444444444444XXX
XXX4444444444444444444444444444444444444444XXX
XXX4444444444444444444444444444444444444444XXX
XXX4444444444444444444444444444444444444444XXX
XXX4444444444444444444444444444444444444444XXX
XXX4444444444444444444444444444444444444444XXX
XXX4444444444444444444444444444444444444444XXX
XXX4444444444444444444444444444444444444444XXX
XXX4444444444444444444444444444444444444444XXX
XXX4444444444444444444444444444444444444444XXX
XXX4444444444444444444444444444444444444444XXX
XXX4444444444444444444444444444444444444444XXX
XXX4444444444444444444444444444444444444444XXX
XXX4444444444444444444444444444444444444444XXX
XXX4444444444444444444444444444444444444444XXX
XXX4444444444444444444444444444444444444444XXX
XXX4444444444444444444444444444444444444444XXX
XXX4444444444444444444444444444444444444444XXX
XXX4444444444444444444444444444444444444444XXX
XXX4444444444444444444444444444444444444444XXX
XXX4444444444444444444444444444444444444444XXX
XXX4444444444444444444444444444444444444444XXX
XXXXXXXXXXXXXXXXXXXXXXXXXXXXXXXXXXXXXXXXXXXXXX
XXXXXXXXXXXXXXXXXXXXXXXXXXXXXXXXXXXXXXXXXXXXXX
XXXXXXXXXXXXXXXXXXXXXXXXXXXXXXXXXXXXXXXXXXXXXX
