ZZZXXXXXXXXXXXXXXXXXXXXXXXXXXXXXXXXXXXXXXXXXXXZZZZZZZZZZZZZZZZZZZZZZZZZZZZZZZZZZZZZZZZXXXZZZ
ZZZXXXXXXXXXXXXXXXXXXXXXXXXXXXXXXXXXXXXXXXXXXXZZZZZZZZZZZZZZZZZZZZZZZZZZZZZZZZZZZZZZZZXXXZZZ
ZZZXXXXXXXXXXXXXXXXXXXXXXXXXXXXXXXXXXXXXXXXXXXZZZZZZZZZZZZZZZZZZZZZZZZZZZZZZZZZZZZZZZZXXXZZZ
ZZZXXX04444444444444444444444444444444444444448888888888888888888888888888888888888888XXXZZZ
ZZZXXX44444444444444444444444444444444444444448888888888888888888888888888888888888888XXXZZZ
ZZZXXX44444444444444444444444444444444444444448888888888888888888888888888888888888888XXXZZZ
ZZZXXX44444444444444444444444444444444444444448888888888888888888888888888888888888888XXXZZZ
ZZZXXX44444444444444444444444444444444444444448888888888888888888888888888888888888888XXXZZZ
ZZZXXX44444444444444444444444444444444444444448888888888888888888888888888888888888888XXXZZZ
ZZZXXX44444444444444444444444444444444444444448888888888888888888888888888888888888888XXXZZZ
ZZZXXX44444444444444444444444444444444444444448888888888888888888888888888888888888888XXXZZZ
ZZZXXX44444444444444444444444444444444444444448888888888888888888888888888888888888888XXXZZZ
ZZZXXX44444444444444444444444444444444444444448888888888888888888888888888888888888888XXXZZZ
ZZZXXX44444444444444444444444444444444444444448888888888888888888888888888888888888888XXXZZZ
ZZZXXX44444444444444444444444444444444444444448888888888888888888888888888888888888888XXXZZZ
ZZZXXX44444444444444444444444444444444444444448888888888888888888888888888888888888888XXXZZZ
ZZZXXX44444444444444444444444444444444444444448888888888888888888888888888888888888888XXXZZZ
ZZZXXX44444444444444444444444444444444444444448888888888888888888888888888888888888888XXXZZZ
ZZZXXX44444444444444444444444444444444444444448888888888888888888888888888888888888888XXXZZZ
ZZZXXX44444444444444444444444444444444444444448888888888888888888888888888888888888888XXXZZZ
ZZZXXX44444444444444444444444444444444444444448888888888888888888888888888888888888888XXXZZZ
ZZZXXX44444444444444444444444444444444444444448888888888888888888888888888888888888888XXXZZZ
ZZZXXX44444444444444444444444444444444444444448888888888888888888888888888888888888888XXXZZZ
ZZZXXX44444444444444444444444444444444444444448888888888888888888888888888888888888888XXXZZZ
ZZZXXX44444444444444444444444444444444444444448888888888888888888888888888888888888888XXXZZZ
ZZZXXX44444444444444444444444444444444444444448888888888888888888888888888888888888888XXXZZZ
ZZZXXX44444444444444444444444444444444444444448888888888888888888888888888888888888888XXXZZZ
ZZZXXX44444444444444444444444444444444444444448888888888888888888888888888888888888888XXXZZZ
ZZZXXXXXXXXXXXXXXXXXXXXXXXXXXXXXXXXXXXXXXXXXXXZZZZZZZZZZZZZZZZZZZZZZZZZZZZZZZZZZZZZZZZXXXZZZ
ZZZXXXXXXXXXXXXXXXXXXXXXXXXXXXXXXXXXXXXXXXXXXXZZZZZZZZZZZZZZZZZZZZZZZZZZZZZZZZZZZZZZZZXXXZZZ
ZZZXXXXXXXXXXXXXXXXXXXXXXXXXXXXXXXXXXXXXXXXXXXZZZZZZZZZZZZZZZZZZZZZZZZZZZZZZZZZZZZZZZZXXXZZZ
